1111111111111111111111111111111111
1X0000000000000C00000C000X00000001
1010010100100000101001000000010101
1110010010101011111001000000010101
1E0000000C00C0011110000000000000C1
111111110000000011100P000000000001
1111111111111111111111111111111111