1111111111111
100000000P0C1
1110001111101
1X0011E000001
1111111111111