1111111
1CC0E11
1011111
1C1P111
1111111